day,claim,adoption_fraction,mean_belief,variance,polarization,r0_like,cluster_penetration,trust_gov,trust_church,trust_local_news,trust_national_news,trust_friends
0,0,0.0010000000474974513,0.2535648047924042,0.0007340916781686246,0.007568183355033398,0.0,0.4545454680919647,0.5478381514549255,0.450175940990448,0.4980145990848541,0.4538286030292511,0.5998144745826721
0,1,0.0010000000474974513,0.25255894660949707,0.000602379790507257,0.006304759532213211,0.0,0.27272728085517883,0.5478381514549255,0.450175940990448,0.4980145990848541,0.4538286030292511,0.5998144745826721
0,2,0.0010000000474974513,0.25344300270080566,0.0006022552261129022,0.005404510535299778,0.0,0.27272728085517883,0.5478381514549255,0.450175940990448,0.4980145990848541,0.4538286030292511,0.5998144745826721
0,3,0.0010000000474974513,0.25590085983276367,0.0005857700598426163,0.003571540117263794,0.0,0.4545454680919647,0.5478381514549255,0.450175940990448,0.4980145990848541,0.4538286030292511,0.5998144745826721
1,0,0.0010000000474974513,0.4236963391304016,0.0007771184900775552,0.002054237062111497,0.0,0.4545454680919647,0.5478381514549255,0.450175940990448,0.4980145990848541,0.4538286030292511,0.5998144745826721
1,1,0.0010000000474974513,0.4165358543395996,0.0005055624642409384,0.0015111248940229416,0.0,0.27272728085517883,0.5478381514549255,0.450175940990448,0.4980145990848541,0.4538286030292511,0.5998144745826721
1,2,0.0010000000474974513,0.4176469147205353,0.0005144705064594746,0.0015289410948753357,0.0,0.27272728085517883,0.5478381514549255,0.450175940990448,0.4980145990848541,0.4538286030292511,0.5998144745826721
1,3,0.0010000000474974513,0.4213041365146637,0.00048671464901417494,0.0014734293799847364,0.0,0.4545454680919647,0.5478381514549255,0.450175940990448,0.4980145990848541,0.4538286030292511,0.5998144745826721
2,0,0.0010000000474974513,0.5566155910491943,0.0006746563012711704,0.0018493125680834055,0.0,0.4545454680919647,0.5478381514549255,0.450175940990448,0.4980145990848541,0.4538286030292511,0.5998144745826721
2,1,0.0010000000474974513,0.5408703088760376,0.0003869527135975659,0.0012739053927361965,0.0,0.27272728085517883,0.5478381514549255,0.450175940990448,0.4980145990848541,0.4538286030292511,0.5998144745826721
2,2,0.0010000000474974513,0.5425149202346802,0.0003952448023483157,0.001290489686653018,0.0,0.27272728085517883,0.5478381514549255,0.450175940990448,0.4980145990848541,0.4538286030292511,0.5998144745826721
2,3,0.0010000000474974513,0.546967089176178,0.0003647106059361249,0.0012294212356209755,0.0,0.4545454680919647,0.5478381514549255,0.450175940990448,0.4980145990848541,0.4538286030292511,0.5998144745826721
3,0,0.0010000000474974513,0.6582883596420288,0.0005176828126423061,0.001535365590825677,0.0,0.4545454680919647,0.5478381514549255,0.450175940990448,0.4980145990848541,0.4538286030292511,0.5998144745826721
3,1,0.0010000000474974513,0.6340055465698242,0.00029218653799034655,0.0010843730997294188,0.0,0.27272728085517883,0.5478381514549255,0.450175940990448,0.4980145990848541,0.4538286030292511,0.5998144745826721
3,2,0.0010000000474974513,0.6359602808952332,0.0002996063558384776,0.0010992127936333418,0.0,0.27272728085517883,0.5478381514549255,0.450175940990448,0.4980145990848541,0.4538286030292511,0.5998144745826721
3,3,0.0010000000474974513,0.6411318182945251,0.00026893935864791274,0.0010378786828368902,0.0,0.4545454680919647,0.5478381514549255,0.450175940990448,0.4980145990848541,0.4538286030292511,0.5998144745826721
4,0,0.0010000000474974513,0.7363587617874146,0.00034136188332922757,0.0011827237904071808,0.0,0.4545454680919647,0.5478381514549255,0.450175940990448,0.4980145990848541,0.4538286030292511,0.5998144745826721
4,1,0.0010000000474974513,0.703790545463562,0.0002138087438652292,0.0009276175405830145,0.0,0.27272728085517883,0.5478381514549255,0.450175940990448,0.4980145990848541,0.4538286030292511,0.5998144745826721
4,2,0.0010000000474974513,0.7059659957885742,0.0002224140625912696,0.0009448281489312649,0.0,0.27272728085517883,0.5478381514549255,0.450175940990448,0.4980145990848541,0.4538286030292511,0.5998144745826721
4,3,0.0010000000474974513,0.7116470336914062,0.0001978733780561015,0.0008957467507570982,0.0,0.4545454680919647,0.5478381514549255,0.450175940990448,0.4980145990848541,0.4538286030292511,0.5998144745826721
5,0,0.438400000333786,0.7950428128242493,0.0002183715405408293,0.2196367383003235,2187.0,1.0,0.5478381514549255,0.450175940990448,0.4980145990848541,0.4538286030292511,0.5998144745826721
5,1,0.0010000000474974513,0.7290114760398865,0.0008495658985339105,0.0021991317626088858,0.0,0.27272728085517883,0.5478381514549255,0.450175940990448,0.4980145990848541,0.4538286030292511,0.5998144745826721
5,2,0.0010000000474974513,0.7313061952590942,0.0008609394426457584,0.0022218788508325815,0.0,0.27272728085517883,0.5478381514549255,0.450175940990448,0.4980145990848541,0.4538286030292511,0.5998144745826721
5,3,0.0010000000474974513,0.7371789813041687,0.0008647008216939867,0.002229401608929038,0.0,0.4545454680919647,0.5478381514549255,0.450175940990448,0.4980145990848541,0.4538286030292511,0.5998144745826721
6,0,0.9904000163078308,0.8390187621116638,0.0001378076703986153,0.4954756200313568,1.26200270652771,1.0,0.5478381514549255,0.450175940990448,0.4980145990848541,0.4538286030292511,0.5998144745826721
6,1,0.0012000000569969416,0.7130343914031982,0.00044916747719980776,0.0014983350411057472,3.0,0.27272728085517883,0.5478381514549255,0.450175940990448,0.4980145990848541,0.4538286030292511,0.5998144745826721
6,2,0.00139999995008111,0.7153289914131165,0.00046022547758184373,0.0016204509884119034,5.0,0.4545454680919647,0.5478381514549255,0.450175940990448,0.4980145990848541,0.4538286030292511,0.5998144745826721
6,3,0.0020000000949949026,0.7210609316825867,0.00045895835501141846,0.0019179168157279491,7.0,0.3636363744735718,0.5478381514549255,0.450175940990448,0.4980145990848541,0.4538286030292511,0.5998144745826721
7,0,1.0,0.8719574213027954,8.630190859548748e-05,0.5001726150512695,0.017391303554177284,1.0,0.5478381514549255,0.450175940990448,0.4980145990848541,0.4538286030292511,0.5998144745826721
7,1,0.0,0.7015539407730103,0.00022630361490882933,0.00045260722981765866,0.0,0.0,0.5478381514549255,0.450175940990448,0.4980145990848541,0.4538286030292511,0.5998144745826721
7,2,0.0,0.7038432359695435,0.0002362389932386577,0.0004724779864773154,0.0,0.0,0.5478381514549255,0.450175940990448,0.4980145990848541,0.4538286030292511,0.5998144745826721
7,3,0.0,0.7094656825065613,0.00023110512120183557,0.00046221024240367115,0.0,0.0,0.5478381514549255,0.450175940990448,0.4980145990848541,0.4538286030292511,0.5998144745826721
8,0,1.0,0.8966014385223389,5.424454502644949e-05,0.5001084804534912,0.0,1.0,0.5478381514549255,0.450175940990448,0.4980145990848541,0.4538286030292511,0.5998144745826721
8,1,0.0,0.693723738193512,0.0001241437712451443,0.0002482875424902886,0.0,0.0,0.5478381514549255,0.450175940990448,0.4980145990848541,0.4538286030292511,0.5998144745826721
8,2,0.0,0.6960180401802063,0.0001335179404122755,0.000267035880824551,0.0,0.0,0.5478381514549255,0.450175940990448,0.4980145990848541,0.4538286030292511,0.5998144745826721
8,3,0.0,0.7015407085418701,0.0001263582380488515,0.000252716476097703,0.0,0.0,0.5478381514549255,0.450175940990448,0.4980145990848541,0.4538286030292511,0.5998144745826721
9,0,1.0,0.9150442481040955,3.419003769522533e-05,0.5000683665275574,0.0,1.0,0.5478381514549255,0.450175940990448,0.4980145990848541,0.4538286030292511,0.5998144745826721
9,1,0.0,0.6883744597434998,7.778461440466344e-05,0.0001555692288093269,0.0,0.0,0.5478381514549255,0.450175940990448,0.4980145990848541,0.4538286030292511,0.5998144745826721
9,2,0.0,0.6906439661979675,8.681754843564704e-05,0.00017363509687129408,0.0,0.0,0.5478381514549255,0.450175940990448,0.4980145990848541,0.4538286030292511,0.5998144745826721
9,3,0.0,0.69610995054245,7.870426634326577e-05,0.00015740853268653154,0.0,0.0,0.5478381514549255,0.450175940990448,0.4980145990848541,0.4538286030292511,0.5998144745826721
10,0,1.0,0.928830087184906,2.1633308278978802e-05,0.5000432729721069,0.0,1.0,0.5478381514549255,0.450175940990448,0.4980145990848541,0.4538286030292511,0.5998144745826721
10,1,0.0,0.6847012042999268,5.718182001146488e-05,0.00011436364002292976,0.0,0.0,0.5478381514549255,0.450175940990448,0.4980145990848541,0.4538286030292511,0.5998144745826721
10,2,0.0,0.6869441866874695,6.600911729037762e-05,0.00013201823458075523,0.0,0.0,0.5478381514549255,0.450175940990448,0.4980145990848541,0.4538286030292511,0.5998144745826721
10,3,0.0,0.6923869252204895,5.738223990192637e-05,0.00011476447980385274,0.0,0.0,0.5478381514549255,0.450175940990448,0.4980145990848541,0.4538286030292511,0.5998144745826721
11,0,1.0,0.9391416907310486,1.3799883163301274e-05,0.500027596950531,0.0,1.0,0.5478381514549255,0.450175940990448,0.4980145990848541,0.4538286030292511,0.5998144745826721
11,1,0.0,0.6821489334106445,4.836225707549602e-05,9.672451415099204e-05,0.0,0.0,0.5478381514549255,0.450175940990448,0.4980145990848541,0.4538286030292511,0.5998144745826721
11,2,0.0,0.6843616962432861,5.719162436434999e-05,0.00011438324872869998,0.0,0.0,0.5478381514549255,0.450175940990448,0.4980145990848541,0.4538286030292511,0.5998144745826721
11,3,0.0,0.6898075342178345,4.802966213901527e-05,9.605932427803054e-05,0.0,0.0,0.5478381514549255,0.450175940990448,0.4980145990848541,0.4538286030292511,0.5998144745826721
12,0,1.0,0.9468368887901306,8.951556083047763e-06,0.5000178813934326,0.0,1.0,0.5478381514549255,0.450175940990448,0.4980145990848541,0.4538286030292511,0.5998144745826721
12,1,0.0,0.6803755164146423,4.487835394684225e-05,8.97567078936845e-05,0.0,0.0,0.5478381514549255,0.450175940990448,0.4980145990848541,0.4538286030292511,0.5998144745826721
12,2,0.0,0.6825428009033203,5.38959247933235e-05,0.000107791849586647,0.0,0.0,0.5478381514549255,0.450175940990448,0.4980145990848541,0.4538286030292511,0.5998144745826721
12,3,0.0,0.6879715919494629,4.434528818819672e-05,8.869057637639344e-05,0.0,0.0,0.5478381514549255,0.450175940990448,0.4980145990848541,0.4538286030292511,0.5998144745826721
13,0,1.0,0.9525789022445679,5.938514732406475e-06,0.5000118613243103,0.0,1.0,0.5478381514549255,0.450175940990448,0.4980145990848541,0.4538286030292511,0.5998144745826721
13,1,0.0,0.6791395545005798,4.373529372969642e-05,8.747058745939285e-05,0.0,0.0,0.5478381514549255,0.450175940990448,0.4980145990848541,0.4538286030292511,0.5998144745826721
13,2,0.0,0.6812495589256287,5.311442509992048e-05,0.00010622885019984096,0.0,0.0,0.5478381514549255,0.450175940990448,0.4980145990848541,0.4538286030292511,0.5998144745826721
13,3,0.0,0.6866642832756042,4.3171949073439464e-05,8.634389814687893e-05,0.0,0.0,0.5478381514549255,0.450175940990448,0.4980145990848541,0.4538286030292511,0.5998144745826721
14,0,1.0,0.9568619132041931,4.056808393215761e-06,0.5000081062316895,0.0,1.0,0.5478381514549255,0.450175940990448,0.4980145990848541,0.4538286030292511,0.5998144745826721
14,1,0.0,0.676763653755188,4.8175064875977114e-05,9.635012975195423e-05,0.0,0.0,0.5478381514549255,0.450175940990448,0.4980145990848541,0.4538286030292511,0.5998144745826721
14,2,0.0,0.6803097724914551,5.349520142772235e-05,0.0001069904028554447,0.0,0.0,0.5478381514549255,0.450175940990448,0.4980145990848541,0.4538286030292511,0.5998144745826721
14,3,0.0,0.6857095956802368,4.327182250563055e-05,8.65436450112611e-05,0.0,0.0,0.5478381514549255,0.450175940990448,0.4980145990848541,0.4538286030292511,0.5998144745826721
15,0,1.0,0.9600669741630554,2.8309962090133922e-06,0.5000056624412537,0.0,1.0,0.5478381514549255,0.450175940990448,0.4980145990848541,0.4538286030292511,0.5998144745826721
15,1,0.0,0.6750737428665161,5.187148053664714e-05,0.00010374296107329428,0.0,0.0,0.5478381514549255,0.450175940990448,0.4980145990848541,0.4538286030292511,0.5998144745826721
15,2,0.0,0.6795939207077026,5.4388248827308416e-05,0.00010877649765461683,0.0,0.0,0.5478381514549255,0.450175940990448,0.4980145990848541,0.4538286030292511,0.5998144745826721
15,3,0.0,0.6841021776199341,4.583379268296994e-05,9.166758536593989e-05,0.0,0.0,0.5478381514549255,0.450175940990448,0.4980145990848541,0.4538286030292511,0.5998144745826721
16,0,1.0,0.9624675512313843,2.0129798485868378e-06,0.5000040531158447,0.0,1.0,0.5478381514549255,0.450175940990448,0.4980145990848541,0.4538286030292511,0.5998144745826721
16,1,0.0,0.6738663911819458,5.4907661251490936e-05,0.00010981532250298187,0.0,0.0,0.5478381514549255,0.450175940990448,0.4980145990848541,0.4538286030292511,0.5998144745826721
16,2,0.0,0.6790325045585632,5.547881664824672e-05,0.00011095763329649344,0.0,0.0,0.5478381514549255,0.450175940990448,0.4980145990848541,0.4538286030292511,0.5998144745826721
16,3,0.0,0.6829501390457153,4.806206561625004e-05,9.612413123250008e-05,0.0,0.0,0.5478381514549255,0.450175940990448,0.4980145990848541,0.4538286030292511,0.5998144745826721
17,0,1.0,0.9642500281333923,1.4989168448664714e-06,0.5000029802322388,0.0,1.0,0.5478381514549255,0.450175940990448,0.4980145990848541,0.4538286030292511,0.5998144745826721
17,1,0.0,0.6729470491409302,5.7628021750133485e-05,0.00011525604350026697,0.0,0.0,0.5478381514549255,0.450175940990448,0.4980145990848541,0.4538286030292511,0.5998144745826721
17,2,0.0,0.6785536408424377,5.677807712345384e-05,0.00011355615424690768,0.0,0.0,0.5478381514549255,0.450175940990448,0.4980145990848541,0.4538286030292511,0.5998144745826721
17,3,0.0,0.6820722818374634,5.02573348057922e-05,0.0001005146696115844,0.0,0.0,0.5478381514549255,0.450175940990448,0.4980145990848541,0.4538286030292511,0.5998144745826721
18,0,1.0,0.9655714631080627,1.1567666433620616e-06,0.5000023245811462,0.0,1.0,0.5478381514549255,0.450175940990448,0.4980145990848541,0.4538286030292511,0.5998144745826721
18,1,0.0,0.6722858548164368,6.020084038027562e-05,0.00012040168076055124,0.0,0.0,0.5478381514549255,0.450175940990448,0.4980145990848541,0.4538286030292511,0.5998144745826721
18,2,0.0,0.6781511902809143,5.811071605421603e-05,0.00011622143210843205,0.0,0.0,0.5478381514549255,0.450175940990448,0.4980145990848541,0.4538286030292511,0.5998144745826721
18,3,0.0,0.6814336180686951,5.185014379094355e-05,0.0001037002875818871,0.0,0.0,0.5478381514549255,0.450175940990448,0.4980145990848541,0.4538286030292511,0.5998144745826721
19,0,1.0,0.9665529131889343,9.226992574440374e-07,0.500001847743988,0.0,1.0,0.5478381514549255,0.450175940990448,0.4980145990848541,0.4538286030292511,0.5998144745826721
19,1,0.0,0.6717343926429749,6.256950291572139e-05,0.00012513900583144277,0.0,0.0,0.5478381514549255,0.450175940990448,0.4980145990848541,0.4538286030292511,0.5998144745826721
19,2,0.0,0.6777924299240112,5.954274456598796e-05,0.00011908548913197592,0.0,0.0,0.5478381514549255,0.450175940990448,0.4980145990848541,0.4538286030292511,0.5998144745826721
19,3,0.0,0.6809767484664917,5.278646494843997e-05,0.00010557292989687994,0.0,0.0,0.5478381514549255,0.450175940990448,0.4980145990848541,0.4538286030292511,0.5998144745826721
